o o o o o o o o o o o o o o o o o o o o o o o o o o o o o o o o o o o o o o o o o o o o o o o o o o o o o o o o o o o o o o o o o
o o o o o o o o o o o o o o o o o o o o o o o o o o o o o o o o o o o o o o o o o o o o o o o o o o o o o o o o o o o o o o o o o
o o o o o o o o o o o o o o o o o o o o o o o o o o o o o o o o o o o o o o o o o o o o o o o o o o o o o o o o o o o o o o o o o
o o o o o o o o o o o o o o o o o o X X X X X X X X X X X X X X X X X X X X X X X X X X X X X o o o o o o o o o o o o o o o o o o
o o o o o o o o o o o o o o o o o o X + . . . . + . . . . . + X X X + . . . . . + . . . . + X o o o o o o o o o o o o o o o o o o
o o o o o o o o o o o o o o o o o o X . X X X X . X X X X X . X X X . X X X X X . X X X X . X o o o o o o o o o o o o o o o o o o
o o o o o o o o o o o o o o o o o o X p X o o X . X o o o X . X X X . X o o o X . X o o X p X o o o o o o o o o o o o o o o o o o
o o o o o o o o o o o o o o o o o o X . X X X X . X X X X X . X X X . X X X X X . X X X X . X o o o o o o o o o o o o o o o o o o
o o o o o o o o o o o o o o o o o o X + . . . . + . . + . . + . . . + . . + . . + . . . . + X o o o o o o o o o o o o o o o o o o
o o o o o o o o o o o o o o o o o o X . X X X X . X X . X X X X X X X X X . X X . X X X X . X o o o o o o o o o o o o o o o o o o
o o o o o o o o o o o o o o o o o o X . X X X X . X X . X X X X X X X X X . X X . X X X X . X o o o o o o o o o o o o o o o o o o
o o o o o o o o o o o o o o o o o o X + . . . . + X X + . . + X X X + . . + X X + . . . . + X o o o o o o o o o o o o o o o o o o
o o o o o o o o o o o o o o o o o o X X X X X X . X X X X X | X X X | X X X X X . X X X X X X o o o o o o o o o o o o o o o o o o
o o o o o o o o o o o o o o o o o o x x x x x X . X X X X X | X X X | X X X X X . X x x x x x o o o o o o o o o o o o o o o o o o
o o o o o o o o o o o o o o o o o o x x x x x X . X X n - - n - n - n - - n X X . X x x x x x o o o o o o o o o o o o o o o o o o
o o o o o o o o o o o o o o o o o o x x x x x X . X X | X X X o | o X X X | X X . X x x x x x o o o o o o o o o o o o o o o o o o
o o o o o o o o o o o o o o o o o o X X X X X X . X X | X o n o | o n o X | X X . X X X X X X o o o o o o o o o o o o o o o o o o
o o o o o o o o o o o o o o o o o o n - - - - - + - - n X o n - n - n o X n - - + - - - - - n o o o o o o o o o o o o o o o o o o
o o o o o o o o o o o o o o o o o o X X X X X X . X X | X o n o o o n o X | X X . X X X X X X o o o o o o o o o o o o o o o o o o
o o o o o o o o o o o o o o o o o o o o o o o X . X X | X X X X X X X X X | X X . X o o o o o o o o o o o o o o o o o o o o o o o
o o o o o o o o o o o o o o o o o o o o o o o X . X X n - - - - n - - - - n X X . X o o o o o o o o o o o o o o o o o o o o o o o
o o o o o o o o o o o o o o o o o o o o o o o X . X X | X X X X X X X X X | X X . X o o o o o o o o o o o o o o o o o o o o o o o
o o o o o o o o o o o o o o o o o o X X X X X X . X X | X X X X X X X X X | X X . X X X X X X o o o o o o o o o o o o o o o o o o
o o o o o o o o o o o o o o o o o o X + . . . . + . . + . . + X X X + . . + . . + . . . . + X o o o o o o o o o o o o o o o o o o
o o o o o o o o o o o o o o o o o o X . X X X X . X X X X X . X X X . X X X X X . X X X X . X o o o o o o o o o o o o o o o o o o
o o o o o o o o o o o o o o o o o o X . X X X X . X X X X X . X X X . X X X X X . X X X X . X o o o o o o o o o o o o o o o o o o
o o o o o o o o o o o o o o o o o o X P . + X X + . . + . . + . . . + . . + . . + X X + . P X o o o o o o o o o o o o o o o o o o
o o o o o o o o o o o o o o o o o o X X X . X X . X X . X X X X X X X X X . X X . X X . X X X o o o o o o o o o o o o o o o o o o
o o o o o o o o o o o o o o o o o o X X X . X X . X X . X X X X X X X X X . X X . X X . X X X o o o o o o o o o o o o o o o o o o
o o o o o o o o o o o o o o o o o o X + . + . . + X X + . . + X X X + . . + X X + . . + . + X o o o o o o o o o o o o o o o o o o
o o o o o o o o o o o o o o o o o o X . X X X X X X X X X X . X X X . X X X X X X X X X X . X o o o o o o o o o o o o o o o o o o
o o o o o o o o o o o o o o o o o o X . X X X X X X X X X X . X X X . X X X X X X X X X X . X o o o o o o o o o o o o o o o o o o
o o o o o o o o o o o o o o o o o o X + . . . . . . . . . . + . . . + . . . . . . . . . . + X o o o o o o o o o o o o o o o o o o
o o o o o o o o o o o o o o o o o o X X X X X X X X X X X X X X X X X X X X X X X X X X X X X o o o o o o o o o o o o o o o o o o
o o o o o o o o o o o o o o o o o o o o o o o o o o o o o o o o o o o o o o o o o o o o o o o o o o o o o o o o o o o o o o o o o
o o o o o o o o o o o o o o o o o o o o o o o o o o o o o o o o o o o o o o o o o o o o o o o o o o o o o o o o o o o o o o o o o
o o o o o o o o o o o o o o o o o o o o o o o o o o o o o o o o o o o o o o o o o o o o o o o o o o o o o o o o o o o o o o o o o


